NO ./path_to_the_north_texture
SO ./path_to_the_south_texture
WE ./path_to_the_west_texture
EA ./path_to_the_east_texture

F 133,130,59
C 165,72,72

111111
100001
100N01
100001
111111