
NO ./wall_texture/wall0.png

SO ./wall_texture/wall1.png


WE ./wall_texture/wall2.png
EA ./wall_texture/wall3.png
F 0,0,255
C 220,0,0

111111
100001
100N01
100001
111111