NO ./wall_texture/wall0.png
SO ./wall_texture/wall1.png
WE ./wall_texture/wall2.png
EA ./wall_texture/wall3.png

F 0,255,0
C 0,0,255

  111111
 10S01111111
  111 111111
  11111111
   