	NO  ./wall_texture/wall0.png
SO ./wall_texture/wall1.png
EA ./wall_texture/wall2.png
WE ./wall_texture/wall0.png

F 220,0,0
C 0,0,255



        1111111111111111111111111
        1000000000110000000000001
        101100000111000000000000111111
        10010000000000000000000011111111
1111111110110000011100000000000000000001
1000000000110000011101111111111111111111
11110111111111011100000010001
11110111111111011101010010001
1100000011010101110000111000111
100000000000E0001100001 1001
10000000000000001101011110001
1100000111010101111101111000111
11110111 1110101 101111010001
11111111 1111111 111111111111
11111111111111111111111111111

